TICKER,YEAR,CALENDAR_YEAR,PERIOD,REVENUE,COST_OF_REVENUE,GROSS_PROFIT,GROSS_PROFIT_RATIO,RESEARCH_AND_DEVELOPMENT_EXPENSES,GENERAL_AND_ADMINISTRATIVE_EXPENSES,SELLING_AND_MARKETING_EXPENSES,SELLING_GENERAL_AND_ADMINISTRATIVE_EXPENSES,OTHER_EXPENSES,OPERATING_EXPENSES,COST_AND_EXPENSES,INTEREST_INCOME,INTEREST_EXPENSE,DEPRECIATION_AND_AMORTIZATION,EBITDA_EARNINGS_BEFORE_INTEREST_TAX_DEPRECATION_AND_AMORITZATION,EBITDA_RATIO,OPERATING_INCOME,OPERATING_INCOME_RATIO,OTHER_INCOME_EXPENSES,INCOME_BEFORE_TAX,INCOME_BEFORE_TAX_RATIO,INCOME_TAX_EXPENSE,NET_INCOME,NET_INCOME_RATIO,EPS_EARNINGS_PER_SHARE,EPS_EARNINGS_PER_SHARE_DILUTED,WEIGHTED_AVERAGE_SHARES_OUTSTANDING,WEIGHTED_AVERAGE_SHARES_OUTSTANDING_DILUTED
AAPL,2022,2022,FY,394328000000,223546000000,170782000000,0.4330963056,26251000000,0,0,25094000000,0,51345000000,274891000000,2825000000,2931000000,11104000000,130541000000,0.3310467428,119437000000,0.302887444,-334000000,119103000000,0.3020404333,19300000000,99803000000,0.2530964071,6.15,6.11,16215963000,16325819000
AAPL,2021,2021,FY,365817000000,212981000000,152836000000,0.4177935963,21914000000,0,0,21973000000,0,43887000000,256868000000,2843000000,2645000000,11284000000,120233000000,0.3286697994,108949000000,0.2978237753,258000000,109207000000,0.2985290459,14527000000,94680000000,0.2588179336,5.67,5.61,16701272000,16864919000
AAPL,2020,2020,FY,274515000000,169559000000,104956000000,0.3823324773,18752000000,0,0,19916000000,0,38668000000,208227000000,3763000000,2873000000,11056000000,77344000000,0.2817478098,66288000000,0.2414731435,803000000,67091000000,0.2443983025,9680000000,57411000000,0.2091361128,3.31,3.28,17352119000,17528214000
AAPL,2019,2019,FY,260174000000,161782000000,98392000000,0.3781776811,16217000000,0,0,18245000000,0,34462000000,196244000000,4961000000,3576000000,12547000000,76477000000,0.2939455903,63930000000,0.2457201719,1807000000,65737000000,0.2526655238,10481000000,55256000000,0.2123809451,2.99,2.97,18471336000,18595652000
AAPL,2018,2018,FY,265595000000,163756000000,101839000000,0.3834371882,14236000000,0,0,16705000000,0,30941000000,194697000000,5686000000,3240000000,10903000000,81801000000,0.3079914908,70898000000,0.2669402662,2005000000,72903000000,0.2744893541,13372000000,59531000000,0.2241420207,3.0,2.98,19821508000,20000436000
AAPL,2017,2017,FY,229234000000,141048000000,88186000000,0.3846986049,11581000000,0,0,15261000000,0,26842000000,167890000000,5201000000,2323000000,10157000000,71501000000,0.311912718,61344000000,0.2676042821,2745000000,64089000000,0.2795789455,15738000000,48351000000,0.2109242085,2.32,2.3,20868968000,21006768000
AAPL,2016,2016,FY,215639000000,131376000000,84263000000,0.3907595565,10045000000,0,0,14194000000,0,24239000000,155615000000,3999000000,1456000000,10505000000,70529000000,0.3270697787,60024000000,0.2783541011,1348000000,61372000000,0.2846052894,15685000000,45687000000,0.2118679831,2.09,2.08,21883280000,22001124000
AAPL,2015,2015,FY,233715000000,140089000000,93626000000,0.4005990202,8067000000,0,0,14329000000,0,22396000000,162485000000,2921000000,733000000,11257000000,82487000000,0.3529384079,71230000000,0.3047729072,1285000000,72515000000,0.3102710566,19121000000,53394000000,0.228457737,2.32,2.31,23013684000,23172276000
AAPL,2014,2014,FY,182795000000,112258000000,70537000000,0.3858803578,6041000000,0,0,11993000000,0,18034000000,130292000000,1795000000,384000000,9310000000,61813000000,0.3381547635,52503000000,0.2872233923,980000000,53483000000,0.2925845893,13973000000,39510000000,0.2161437676,1.62,1.61,24342288000,24490652000
AAPL,2013,2013,FY,170910000000,106606000000,64304000000,0.3762448072,4475000000,0,0,10830000000,0,15305000000,121911000000,1616000000,136000000,6757000000,55756000000,0.3262301796,48999000000,0.2866947516,1156000000,50155000000,0.2934585454,13118000000,37037000000,0.2167046984,1.43,1.42,25909268000,26086536000
AAPL,2012,2012,FY,156508000000,87846000000,68662000000,0.4387123981,3381000000,0,0,10040000000,0,13421000000,101267000000,1088000000,-522000000,3277000000,58518000000,0.3738978199,55241000000,0.3529595931,522000000,55763000000,0.3562948859,14030000000,41733000000,0.266650906,1.59,1.58,26174904000,26469940000
AAPL,2011,2011,FY,108249000000,64431000000,43818000000,0.4047889588,2429000000,0,0,7599000000,0,10028000000,74459000000,519000000,-415000000,1814000000,35604000000,0.3289083502,33790000000,0.3121506896,415000000,34205000000,0.3159844433,8283000000,25922000000,0.2394664154,1.0,0.99,25879224000,26226060000
AAPL,2010,2010,FY,65225000000,39541000000,25684000000,0.3937753929,1782000000,0,0,5517000000,0,7299000000,46840000000,311000000,-155000000,1027000000,19412000000,0.2976159448,18385000000,0.2818704484,155000000,18540000000,0.2842468379,4527000000,14013000000,0.2148409352,0.55,0.54,25464908000,25891936000
AAPL,2009,2009,FY,36537000000,23397000000,13140000000,0.359635438,1333000000,0,0,4149000000,0,5482000000,28879000000,407000000,-326000000,703000000,8361000000,0.2288365219,7658000000,0.2095957523,326000000,7984000000,0.2185182144,2280000000,5704000000,0.1561157183,0.23,0.22,25004448000,25396140000
AAPL,2008,2008,FY,32479000000,21334000000,11145000000,0.3431448013,1109000000,0,0,3761000000,0,4870000000,26204000000,653000000,-620000000,473000000,6748000000,0.2077650174,6275000000,0.1932017611,620000000,6895000000,0.2122910188,2061000000,4834000000,0.1488346316,0.2,0.19,24684576000,25259892000
AAPL,2007,2007,FY,24006000000,15852000000,8154000000,0.3396650837,782000000,0,0,2963000000,0,3745000000,19597000000,647000000,-599000000,317000000,4726000000,0.1968674498,4409000000,0.1836624177,599000000,5008000000,0.208614513,1512000000,3496000000,0.1456302591,0.14,0.14,24208660000,24900176000
AAPL,2006,2006,FY,19315000000,13717000000,5598000000,0.2898265597,712000000,0,0,2433000000,0,3145000000,16862000000,394000000,-365000000,590000000,3043000000,0.1575459487,2453000000,0.1269997411,365000000,2818000000,0.1458969713,829000000,1989000000,0.1029769609,0.0843,0.0811,23633624000,24570728000
AAPL,2005,2005,FY,13931000000,9888000000,4043000000,0.2902160649,534000000,0,0,1859000000,0,2393000000,12281000000,0,-165000000,179000000,1829000000,0.1312899289,1650000000,0.1184408872,165000000,1815000000,0.130284976,480000000,1335000000,0.0958294451,0.0586,0.0554,22636292000,23992584000
AAPL,2004,2004,FY,8279000000,6020000000,2259000000,0.2728590409,489000000,0,0,1421000000,0,1910000000,7930000000,64000000,3000000,228000000,554000000,0.0669162942,326000000,0.0393767363,57000000,383000000,0.0462616258,107000000,276000000,0.0333373596,0.0129,0.0121,20809040000,21693728000
AAPL,2003,2003,FY,6207000000,4499000000,1708000000,0.2751731916,471000000,0,0,1212000000,0,1683000000,6182000000,69000000,8000000,113000000,202000000,0.032543902,89000000,0.0143386499,3000000,92000000,0.0148219752,24000000,69000000,0.0111164814,0.0036,0.0032,20195336000,20354096000
AAPL,2002,2002,FY,5742000000,4139000000,1603000000,0.2791710206,447000000,0,0,1111000000,0,1558000000,5697000000,118000000,11000000,118000000,286000000,0.0498084291,168000000,0.0292580982,-81000000,87000000,0.0151515152,22000000,65000000,0.0113200975,0.0032,0.0032,19881232000,20259960000
AAPL,2001,2001,FY,5363000000,4128000000,1235000000,0.2302815588,441000000,0,0,1138000000,0,1579000000,5707000000,218000000,16000000,328000000,-16000000,-0.0029834048,-344000000,-0.0641432034,292000000,-52000000,-0.0096960656,-15000000,-37000000,-0.0068991236,-0.0019,-0.0019,19354328000,19354328000
AAPL,2000,2000,FY,7983000000,5817000000,2166000000,0.271326569,380000000,0,0,1166000000,0,1546000000,7363000000,210000000,21000000,84000000,920000000,0.1152448954,836000000,0.1047225354,256000000,1092000000,0.1367906802,306000000,786000000,0.0984592259,0.0432,0.0389,18175808000,20178144000
AAPL,1999,1999,FY,6134000000,4438000000,1696000000,0.2764916857,314000000,0,0,996000000,0,1310000000,5748000000,144000000,47000000,85000000,613000000,0.0999347897,528000000,0.0860776003,148000000,676000000,0.1102054125,75000000,601000000,0.0979784806,0.0375,0.0323,16033584000,19506368000
AAPL,1998,1998,FY,5941000000,4462000000,1479000000,0.2489479886,310000000,0,0,908000000,0,1218000000,5680000000,100000000,62000000,111000000,504000000,0.084834203,393000000,0.0661504797,-64000000,329000000,0.0553778825,20000000,309000000,0.0520114459,0.0209,0.0188,14781088000,18806704000
AAPL,1997,1997,FY,7081000000,5713000000,1368000000,0.1931930518,860000000,0,0,1286000000,0,2146000000,7859000000,82000000,71000000,203000000,-575000000,-0.0812032199,-778000000,-0.1098714871,-267000000,-1045000000,-0.1475780257,281000000,-1326000000,-0.1872616862,-0.0939,-0.0939,14118944000,14118944000
AAPL,1996,1996,FY,9833000000,8865000000,968000000,0.0984440151,604000000,0,0,1568000000,0,2172000000,11037000000,60000000,60000000,213000000,-991000000,-0.1007830774,-1204000000,-0.1224448286,-91000000,-1295000000,-0.1316993796,-479000000,-816000000,-0.0829858639,-0.0589,-0.0589,13858208000,13858208000
AAPL,1995,1995,FY,11062000000,8204000000,2858000000,0.2583619599,614000000,0,0,1583000000,0,2197000000,10401000000,100000000,48000000,203000000,887000000,0.0801844151,684000000,0.0618333032,-10000000,674000000,0.0609293075,250000000,424000000,0.038329416,0.0308,0.0308,13781264000,13781264000
AAPL,1994,1994,FY,9188748000,6844915000,2343833000,0.2550764261,564303000,0,0,1384111000,0,1948414000,8793329000,43284000,39653000,93072000,615346000,0.0669673387,522274000,0.0568384289,-21988000,500286000,0.0544455023,190108000,310178000,0.0337562854,0.0233,0.0233,13298320000,13298320000
AAPL,1993,1993,FY,7977000000,5082700000,2894300000,0.3628306381,0,0,0,2617800000,166100000,2783900000,7866600000,0,-58600000,166100000,247200000,0.0309890936,81100000,0.0101667293,58600000,139700000,0.0175128494,53100000,86600000,0.0108562116,0.0065,0.0065,13342000000,13424000000
AAPL,1992,1992,FY,7086500000,3774200000,3312300000,0.4674098638,0,0,0,2289400000,217200000,2506600000,6280800000,0,-99400000,167600000,973300000,0.1373456572,805700000,0.113695054,49800000,855500000,0.1207225005,325100000,530400000,0.0748465392,0.0387,0.0387,13718880000,13729632000
AAPL,1991,1991,FY,6308800000,3109700000,3199100000,0.5070853411,0,0,0,2547400000,204400000,2751800000,5861500000,0,-104800000,152000000,599300000,0.0949942937,447300000,0.0709009637,52400000,499700000,0.0792068222,189900000,309800000,0.0491060107,0.023,0.023,13448682171,13448682171
AAPL,1990,1990,FY,5558400000,2403500000,3154900000,0.5675913932,0,0,0,2240200000,202700000,2442900000,4846400000,0,-133000000,136200000,848200000,0.1525978699,712000000,0.1280944157,66500000,778500000,0.1400582902,303600000,474900000,0.0854382556,0.0338,0.0338,14071111111,14071111111
AAPL,1989,1989,FY,5284000000,2570000000,2714000000,0.5136260409,0,0,0,1954900000,124800000,2079700000,4649700000,0,-220000000,14800000,649100000,0.1228425435,634300000,0.1200416351,110000000,744300000,0.1408591976,290300000,454000000,0.0859197578,0.0316,0.0316,14363841808,14363841808
AAPL,1988,1988,FY,4071400000,1913200000,2158200000,0.5300879304,0,0,0,1460200000,77700000,1537900000,3451100000,0,-71700000,41900000,662200000,0.1626467554,620300000,0.1523554551,35900000,656200000,0.1611730609,255900000,400300000,0.0983199882,0.0275,0.0275,14556363636,14556363636
AAPL,1987,1987,FY,2661100000,1225700000,1435400000,0.5394009996,0,0,0,993400000,70500000,1063900000,2289600000,0,-77800000,31600000,403100000,0.1514787118,371500000,0.1396039232,38900000,410400000,0.1542219383,192900000,217500000,0.0817331179,0.0148,0.0148,14674698795,14674698795
AAPL,1986,1986,FY,1901900000,840000000,1061900000,0.5583364004,0,0,0,737300000,51100000,788400000,1628400000,0,-72500000,14900000,288400000,0.1516378358,273500000,0.1438035649,36300000,309800000,0.1628897418,155800000,154000000,0.0809716599,0.0107,0.0107,14373333333,14373333333
AAPL,1985,1985,FY,1918300000,1076000000,842300000,0.4390866913,0,0,0,653200000,41800000,695000000,1771000000,0,54500000,69000000,216300000,0.1127560861,147300000,0.0767867383,-27300000,120000000,0.0625553876,58800000,61200000,0.0319032477,0.0045,0.0045,13708800000,13708800000
